{
  "map": {
    "size": { "width": 16, "height": 26 },
    "map": [
      [3, 2, 2, 2, 2, 1, 2, 2, 3, 2, 2, 2, 2, 2, 2, 1],
      [1, 0, 0, 0, 0, 1, 0, 0, 1, 0, 0, 0, 0, 0, 0, 1],
      [1, 0, 0, 0, 0, 5, 0, 0, 1, 0, 0, 0, 0, 0, 0, 1],
      [1, 0, 0, 0, 0, 1, 0, 0, 1, 0, 0, 0, 0, 0, 0, 1],
      [1, 0, 0, 0, 0, 1, 0, 0, 2, 4, 2, 2, 2, 2, 2, 1],
      [3, 2, 2, 2, 2, 1, 0, 0, 0, 0, 0, 0, 0, 0, 0, 1],
      [1, 0, 0, 0, 0, 5, 0, 0, 0, 0, 0, 0, 0, 0, 0, 1],
      [1, 0, 0, 0, 0, 3, 2, 2, 2, 2, 2, 2, 1, 0, 0, 1],
      [1, 0, 0, 0, 0, 1, 0, 0, 0, 0, 0, 0, 1, 0, 0, 1],
      [1, 0, 0, 0, 0, 1, 0, 0, 0, 0, 0, 0, 1, 0, 0, 1],
      [3, 2, 2, 2, 2, 1, 0, 0, 0, 0, 0, 0, 1, 0, 0, 1],
      [1, 0, 0, 0, 0, 1, 0, 0, 0, 0, 0, 0, 1, 0, 0, 1],
      [1, 0, 0, 0, 0, 3, 2, 2, 2, 2, 4, 2, 1, 0, 0, 1],
      [1, 0, 0, 0, 0, 5, 0, 0, 0, 0, 0, 0, 0, 0, 0, 1],
      [1, 0, 0, 0, 0, 1, 0, 0, 0, 0, 0, 0, 0, 0, 0, 1],
      [11, 2, 2, 2, 2, 0, 0, 0, 0, 0, 3, 4, 1, 1, 1, 1],
      [11, 0, 0, 0, 0, 0, 0, 0, 0, 0, 1, 0, 0, 0, 0, 1],
      [1, 0, 0, 0, 0, 3, 2, 2, 4, 2, 1, 0, 0, 0, 0, 1],
      [7, 0, 0, 0, 0, 1, 0, 0, 0, 0, 1, 0, 0, 0, 0, 1],
      [7, 0, 0, 0, 0, 1, 0, 0, 0, 0, 1, 0, 0, 0, 0, 1],
      [3, 2, 2, 4, 2, 1, 0, 0, 0, 0, 1, 0, 0, 0, 0, 1],
      [1, 0, 0, 0, 0, 1, 0, 0, 0, 0, 1, 0, 0, 0, 0, 1],
      [1, 0, 0, 0, 0, 1, 0, 0, 0, 0, 1, 0, 0, 0, 0, 1],
      [1, 0, 0, 0, 0, 1, 0, 0, 0, 0, 1, 0, 0, 0, 0, 1],
      [1, 0, 0, 0, 0, 1, 0, 0, 0, 0, 1, 0, 0, 0, 0, 1],
      [2, 2, 2, 2, 2, 2, 2, 2, 2, 2, 2, 2, 2, 2, 2, 0]
    ],
    "exitLocations": {
      "passages": [
        { "cellPosition": [18, 0], "destination": { "buildingCode": "D", "floorNumber": 2 } },
        { "cellPosition": [19, 0], "destination": { "buildingCode": "D", "floorNumber": 2 } }
      ],
      "elevators": [{ "cellPosition": [15, 0] }, { "cellPosition": [16, 0] }]
    }
  }
}
