{
  "maze": {
    "size": { "width": 16, "depth": 26 },
    "buildingCode": "C",
    "floorNumber": 1,
    "map": [
      [3, 2, 2, 2, 2, 2, 2, 2, 3, 2, 3, 2, 2, 2, 2, 1],
      [1, 0, 0, 0, 0, 0, 0, 0, 1, 0, 1, 0, 0, 0, 0, 1],
      [1, 0, 0, 0, 0, 0, 0, 0, 5, 0, 5, 0, 0, 0, 0, 1],
      [1, 0, 0, 0, 0, 0, 0, 0, 1, 0, 1, 0, 0, 0, 0, 1],
      [1, 0, 0, 0, 0, 0, 0, 0, 1, 0, 1, 0, 0, 0, 0, 1],
      [3, 2, 2, 2, 2, 2, 2, 2, 1, 0, 3, 2, 2, 2, 2, 1],
      [1, 0, 0, 0, 0, 0, 0, 0, 1, 0, 1, 0, 0, 0, 0, 1],
      [1, 0, 0, 0, 0, 0, 0, 0, 5, 0, 5, 0, 0, 0, 0, 1],
      [1, 0, 0, 0, 0, 0, 0, 0, 1, 0, 1, 0, 0, 0, 0, 1],
      [1, 0, 0, 0, 0, 0, 0, 0, 1, 0, 1, 0, 0, 0, 0, 1],
      [3, 2, 2, 2, 2, 2, 2, 2, 0, 0, 3, 2, 2, 2, 2, 1],
      [1, 0, 0, 0, 0, 0, 0, 0, 0, 0, 1, 0, 0, 0, 0, 1],
      [1, 0, 0, 0, 0, 0, 0, 0, 0, 0, 5, 0, 0, 0, 0, 1],
      [1, 0, 0, 0, 0, 0, 0, 0, 0, 0, 1, 0, 0, 0, 0, 1],
      [1, 0, 0, 0, 0, 0, 0, 0, 0, 0, 1, 0, 0, 0, 0, 1],
      [11, 0, 0, 0, 0, 0, 0, 0, 0, 0, 3, 2, 2, 2, 2, 1],
      [11, 0, 0, 0, 0, 0, 0, 0, 0, 0, 1, 0, 0, 0, 0, 1],
      [1, 0, 0, 0, 0, 0, 0, 0, 0, 0, 5, 0, 0, 0, 0, 1],
      [1, 0, 0, 0, 0, 0, 0, 0, 0, 0, 1, 0, 0, 0, 0, 1],
      [1, 0, 0, 0, 0, 0, 0, 0, 0, 0, 1, 0, 0, 0, 0, 1],
      [3, 2, 2, 2, 2, 2, 2, 2, 1, 0, 3, 2, 2, 2, 2, 1],
      [1, 0, 0, 0, 0, 0, 0, 0, 1, 0, 1, 0, 0, 0, 0, 1],
      [1, 0, 0, 0, 0, 0, 0, 0, 5, 0, 5, 0, 0, 0, 0, 1],
      [1, 0, 0, 0, 0, 0, 0, 0, 1, 0, 1, 0, 0, 0, 0, 1],
      [1, 0, 0, 0, 0, 0, 0, 0, 1, 0, 1, 0, 0, 0, 0, 1],
      [2, 2, 2, 2, 2, 2, 2, 2, 2, 2, 2, 2, 2, 2, 2, 0]
    ],
    "exitLocations": {
      "passages": [],
      "elevators": [{ "cellPosition": [15, 0] }, { "cellPosition": [16, 0] }]
    }
  }
}
