{
  "maze": {
    "size": { "width": 16, "depth": 26 },
    "buildingCode": "D",
    "floorNumber": 2,
    "map": [
      [11, 2, 2, 2, 2, 2, 2, 2, 2, 2, 2, 2, 2, 2, 2, 7],
      [11, 0, 0, 0, 0, 0, 0, 0, 0, 0, 0, 0, 0, 0, 0, 7],
      [3, 2, 2, 2, 2, 1, 0, 0, 3, 2, 2, 2, 2, 2, 2, 1],
      [1, 0, 0, 0, 0, 5, 0, 0, 1, 0, 0, 0, 0, 0, 0, 1],
      [1, 0, 0, 0, 0, 1, 0, 0, 1, 0, 0, 0, 0, 0, 0, 1],
      [3, 2, 2, 2, 2, 1, 0, 0, 1, 0, 0, 0, 0, 0, 0, 1],
      [1, 0, 0, 0, 0, 1, 0, 0, 1, 0, 0, 0, 0, 0, 0, 1],
      [1, 0, 0, 0, 0, 1, 0, 0, 1, 0, 0, 0, 0, 0, 0, 1],
      [1, 0, 0, 0, 0, 1, 0, 0, 1, 0, 0, 0, 0, 0, 0, 1],
      [1, 0, 0, 0, 0, 1, 0, 0, 1, 0, 0, 0, 0, 0, 0, 1],
      [1, 0, 0, 0, 0, 1, 0, 0, 1, 0, 0, 0, 0, 0, 0, 1],
      [1, 0, 0, 0, 0, 5, 0, 0, 5, 0, 0, 0, 0, 0, 0, 1],
      [1, 0, 0, 0, 0, 1, 0, 0, 1, 0, 0, 0, 0, 0, 0, 1],
      [1, 0, 0, 0, 0, 1, 0, 0, 1, 0, 0, 0, 0, 0, 0, 1],
      [1, 0, 0, 0, 0, 1, 0, 0, 1, 0, 0, 0, 0, 0, 0, 1],
      [3, 2, 2, 2, 2, 1, 0, 0, 2, 2, 3, 2, 2, 2, 2, 1],
      [1, 0, 0, 0, 0, 1, 0, 0, 0, 0, 1, 0, 0, 0, 0, 1],
      [1, 0, 0, 0, 0, 5, 0, 0, 0, 0, 5, 0, 0, 0, 0, 1],
      [1, 0, 0, 0, 0, 1, 0, 0, 0, 0, 1, 0, 0, 0, 0, 1],
      [1, 0, 0, 0, 0, 1, 0, 0, 0, 0, 1, 0, 0, 0, 0, 1],
      [1, 0, 0, 0, 0, 3, 2, 4, 2, 2, 2, 2, 2, 2, 2, 1],
      [1, 0, 0, 0, 0, 1, 0, 0, 0, 0, 0, 0, 0, 0, 0, 1],
      [1, 0, 0, 0, 0, 1, 0, 0, 0, 0, 0, 0, 0, 0, 0, 1],
      [1, 0, 0, 0, 0, 1, 0, 0, 0, 0, 0, 0, 0, 0, 0, 1],
      [1, 0, 0, 0, 0, 1, 0, 0, 0, 0, 0, 0, 0, 0, 0, 1],
      [2, 2, 2, 2, 2, 2, 2, 2, 2, 2, 2, 2, 2, 2, 2, 0]
    ],
    "exitLocations": {
      "passages": [{ "cellPosition": [0, 15] }, { "cellPosition": [1, 15] }],
      "elevators": [{ "cellPosition": [0, 0] }, { "cellPosition": [1, 0] }]
    }
  }
}
